NO srcs/textures/north.xpm
SO srcs/textures/south.xpm
WE srcs/textures/west.xpm
EA srcs/textures/east.xpm
F 150,30,10
C 150,30,10



111111111111111111111111111111111111111111111111111111111111111111111111111111111111111111111111111111111111111111111111111
111111111111111111111111111111111111111111111111111111111111111111111111111111111111111111111111111111111111111111111111111
111111111111111111111111111111111111111111111111111111111111111111111111111111111111111111111111111111111111111111111111111
111111111111111111111111111111111111111111111111111111111111111111111111111111111111111111111111111111111111111111111111111
111111111111111000000000011111111111111111111111111111111111111111111111111111111111111111111111111111111111111111111111111
111111111111111000000000011111111111111111111111111111111111111111111111111111111111111111111111111111111111111111111111111
111111111111111000000000011111111111111111111111111111111111111111111111111111111111111111111111111111111111111111111111111
111111111111111000000000011111111111111111111111111111111111111111111111111111111111111111111111111111111111111111111111111
111111111111111000000000011111111111111111111111111111111111111111111111111111111111111111111111111111111111111111111111111
111111111111111111111111111111111111111111111111111111111111111111111111111111111111111111111111111111111111111111111111111
111111111111111111111111111111111111111111111111111111111111111111111111111111111111111111111111111111111111111111111111111
111111111111111111111111111111111111111111111111111111111111111111111111111111111111111111111111111111111111111111111111111
111111111111111111111111111111111111111111111111111111111111111111111111111111111111111111111111111111111111111111111111111
111111111111111111111111111111111111111111111111111111111111111111111111111111111111111111111111111111111111111111111111111
111111111111111111111111111111111111111111111111111111111111111111111111111111111111111111111111111111111111111111111111111
111111111111111111111111111111111111111111111111111111111111111111111111111111111111111111111111111111111111111111111111111
111111111111111111111111111111111111111111111111111111111111111111111111111111111111111111111111111111111111111111111111111
111111111111111111111111111111111111111111111111111111111111111111111111111111111111111111111111111111111111111111111111111
111111111111111111111111111111111111111111111111111111111111111111111111111111111111111111111111111111111111111111111111111
111111111111111111111111111111111111111111111111111111111111111111111111111111111111111111111111111111111111111111111111111
111111111111111111111111111111111111111111111111111111111111111111111111111111111111111111111111111111111111111111111111111
111111111111111111111111111111111111111111111111111111111111111111111111111111111111111111111111111111111111111111111111111
111111111111111111111111111111111111111111111111111111111111111111111111111111111111111111111111111111111111111111111111111
111111111111111111111111111111111111111111111111111111111111111111111111111111111111111111111111111111111111111111111111111
111111111111111111111111111111111111111111111111111111111111111111111111111111111111111111111111111111111111111111111111111
111111111111111111111111111111111111111111111111111111111111111111111111111111111111111111111111111111111111111111111111111
111111111111111111111111111111111111111111111111111111111111111111111111111111111111111111111111111111111111111111111111111
111111111111111111111111111111111111111111111111111111111111111111111111111111111111111111111111111111111111111111111111111
111111111111111111111111111111111111111111111111111111111111111111111111111111111111111111111111111111111111111111111111111
111111111111111111111111111111111111111111111111111111111111111111111111111111111111111111111111111111111111111111111111111
111111111111111100000000000000000000000000000000000000000000000000000000000000000000000000000000000000011111111111111111111
111111111111111100000000000000000000000000000000000000000000000000000000000000000000000000000000000000011111111111111111111
111111111111111100000000000000000000000000000000000000000000000000000000000000000000000000000000000000011111111111111111111
111111111111111100000000000000000000000000000000000000000000000000000000000000000000000000000000000000011111111111111111111
111111111111111100000000000000000000000000000000000000000000000000000000000000000000000000000000000000011111111111111111111
111111111111111100000000000000000000000000000000000000000000000000000000000000000000000000000000000000011111111111111111111
111111111111111100000000000000000000000000000000000000000000000000000000000000000000000000000000000000011111111111111111111
111111111111111100000000000000000000000000000000000000000000000000000000000000000000000000000000000000011111111111111111111
111111111111111100000000000000000000000000000000000000000000000000000000000000000000000000000000000000011111111111111111111
111111111111111100000000000000000000000000000000000000000000000000000000000000000000000000000000000000011111111111111111111
111111111111111100000000000000000000000000000000000000000000000000000000000000000000000000000000000000011111111111111111111
111111111111111100000000000000000000000000000000000000000000000000000000000000000000000000000000000000011111111111111111111
111111111111111100000000000000000000000000000000000000000000000000000000000000000000000000000000000000011111111111111111111
111111111111111100000000000000000000000000000000000000000000000000000000000000000000000000000000000000011111111111111111111
111111111111111100000000000000000000000000000000000000000000000000000000000000000000000000000000000000011111111111111111111
111111111111111100000000000000000000000000000000000000000000000000000000000000000000000000000000000000011111111111111111111
111111111111111100000000000000000000000000000000000000000000000000000000000000000000000000000000000000011111111111111111111
111111111111111100000000000000000000000000000000000000000000000000000000000000000000000000000000000000011111111111111111111
111111111111111100000000000000000000000000000000000000000000000000000000000000000000000000000000000000011111111111111111111
111111111111111100000000000000000000000000000000000000000000000010000000000000000000000000000000000000011111111111111111111
111111111111111100000000000000000000000000000000000000000000000000000000000000000000000000000000000000011111111111111111111
111111111111111100000000000000000000000000000000000000000000000000000000000000000000000000000000000000011111111111111111111
111111111111111100000000000000000000000000000000000000000000000000000000000000000000000000000000000000011111111111111111111
111111111111111100000000000000000000010000000000000000000000000000000000000000000000000000000000000000011111111111111111111
111111111111111100000000000000000000000000000000000000000000000000000000000000000000000000000000000000011111111111111111111
111111111111111100000000000000000000000000000000000000000000000000000000001000000000000000000000000000011111111111111111111
111111111111111100000000000000000000000000000000000000000000000000000000000000000000000000000000000000011111111111111111111
111111111111111100000000000000000000000000000000000000000000000000000000000000000000000000000000000000011111111111111111111
111111111111111100000000000000000000000000000000000000000000000000000000000000000000000000000000000000011111111111111111111
111111111111111100000000000000000000000000000000000000000000000000000000000000000000000000000000000000011111111111111111111
111111111111111100000000000000000000000000000000000000000000000000000000000000000000000000000000000000011111111111111111111
111111111111111100000000000000000000000000000000000000000000000000010000000000000000000000000000000000011111111111111111111
111111111111111100000000000000000000000000000000000000000000000000000000000000000000000000000000000000011111111111111111111
111111111111111100000000000000000000000000000000000000000000111111111111111100000001100000000000000000011111111111111111111
111111111111111100000000000000000000000000000000000000000000000000000010000000000000000000000000000000011111111111111111111
11111111111111110000000000000000000000000000000000000000000000000000S00000000000000000001000000000000011111111111111111111
111111111111111100000000000000000000000000000000001000000000000100000001000000000001100000000000000000011111111111111111111
111111111111111100000000000000000000000000000000000000000000000000000000000000000000000000100000000000011111111111111111111
111111111111111100000000000000000000000000000000000000000000000000001000000010000000000000000000000000011111111111111111111
111111111111111100000000000000000000100000000000000001000000000000000000100000000000000000000000000000011111111111111111111
11111111111111110000000000000000001000000000000000000000000000000000000000000000001000000000010000000000011111111111111111111
111111111111111100000000000000000000000000010000000000000000000000000000000000000000000000010000000000011111111111111111111
111111111111111100000000000000000000000000000000000100100000000000010000000000000000000000000000000000011111111111111111111
111111111111111100000000000000000010000000000000000000110000000000000000000000000000100000000000000000011111111111111111111
111111111111111100000000000000000010000000000000000000000001000000000000000000000000000000000000000000011111111111111111111
111111111111111100000000000000000000000000000000000000000000000000000000010000000000000000100000000000011111111111111111111
11111111111111110000000000000000000010000000000010000000001000000000000000000000000000000000000000000000011111111111111111111
111111111111111100000000000000000000000000100000000000000000000000000000000000000000000000000000000000011111111111111111111
1111111111111111000000000000000000000000001000000000000000000100000000000000000000000001000000000000011111111111111111111
111111111111111100000000000000000000000000000000000001000000000000001000000010000000000000000000000000011111111111111111111
111111111111111100000000000000000000000000000000000000000000000000000000000000000000000000000000000000011111111111111111111
111111111111111100000000000000000000000000000000000000000000000000000000000000000000000000000000000000011111111111111111111
111111111111111100000000000000000000000000000000000000000000000000000000000000000000000000000000000000011111111111111111111
111111111111111100000000000000000000000000000000000000000000000000000000000000000000000000000000000000011111111111111111111
111111111111111100000000000000000000000000000000000000000000000000000000000000000000000000000000000000011111111111111111111
111111111111111100000000000000000000000000000000000000000000000000000000000000000000000000000000000000011111111111111111111
111111111111111100000000000000000000000000000000000000000000000000000000000000000000000000000000000000011111111111111111111
111111111111111100000000000000000000000000000000000000000000000000000000000000000000000000000000000000011111111111111111111
111111111111111100000000000000000000000000000000000000000000000000000000000000000000000000000000000000011111111111111111111
111111111111111100000000000000000000000000000000000000000000000000000000000000000000000000000000000000011111111111111111111
111111111111111100000000000000000000000000000000000000000000000000000000000000000000000000000000000000011111111111111111111
111111111111111100000000000000000000000000000000000000000000000000000000000000000000000000000000000000011111111111111111111
111111111111111100000000000000000000000000000000000000000000000000000000000000000000000000000000000000011111111111111111111
111111111111111100000000000000000000000000000000000000000000000000000000000000000000000000000000000000011111111111111111111
111111111111111100000000000000000000000000000000000000000000000000000000000000000000000000000000000000011111111111111111111
111111111111111100000000000000000000000000000000000000000000000000000000000000000000000000000000000000011111111111111111111
111111111111111100000000000000000000000000000000000000000000000000000000000000000000000000000000000000011111111111111111111
111111111111111100000000000000000000000000000000000000000000000000000000000000000000000000000000000000011111111111111111111
111111111111111100000000000000000000000000000000000000000000000000000000000000000000000000000000000000011111111111111111111
111111111111111100000000000000000000000000000000000000000000000000000000000000000000000000000000000000011111111111111111111
111111111111111100000000000000000000000000000000000000000000000000000000000000000000000000000000000000011111111111111111111
111111111111111100000000000000000000000000000000000000000000000000000000000000000000000000000000000000011111111111111111111
111111111111111100000000000000000000000000000000000000000000000000000000000000000000000000000000000000011111111111111111111
111111111111111100000000000000000000000000000000000000000000000000000000000000000000000000000000000000011111111111111111111
111111111111111100000000000000000000000000000000000000000000000000000000000000000000000000000000000000011111111111111111111
111111111111111100000000000000000000000000000000000000000000000000000000000000000000000000000000000000011111111111111111111
111111111111111100000000000000000000000000000000000000000000000000000000000000000000000000000000000000011111111111111111111
111111111111111100000000000000000000000000000000000000000000000000000000000000000000000000000000000000011111111111111111111
111111111111111100000000000000000000000000000000000000000000000000000000000000000000000000000000000000011111111111111111111
111111111111111100000000000000000000000000000000000000000000000000000000000000000000000000000000000000011111111111111111111
111111111111111100000000000000000000000000000000000000000000000000000000000000000000000000000000000000011111111111111111111
111111111111111100000000000000000000000000000000000000000000000000000000000000000000000000000000000000011111111111111111111
111111111111111100000000000000000000000000000000000000000000000000000000000000000000000000000000000000011111111111111111111
111111111111111100000000000000000000000000000000000000000000000000000000000000000000000000000000000000011111111111111111111
111111111111111100000000000000000000000000000000000000000000000000000000000000000000000000000000000000011111111111111111111
111111111111111100000000000000000000000000000000000000000000000000000000000000000000000000000000000000011111111111111111111
111111111111111100000000000000000000000000000000000000000000000000000000000000000000000000000000000000011111111111111111111
111111111111111100000000000000000000000000000000000000000000000000000000000000000000000000000000000000011111111111111111111
111111111111111100000000000000000000000000000000000000000000000000000000000000000000000000000000000000011111111111111111111
111111111111111100000000000000000000000000000000000000000000000000000000000000000000000000000000000000011111111111111111111
111111111111111100000000000000000000000000000000000000000000000000000000000000000000000000000000000000011111111111111111111
111111111111111100000000000000000000000000000000000000000000000000000000000000000000000000000000000000011111111111111111111
111111111111111100000000000000000000000000000000000000000000000000000000000000000000000000000000000000011111111111111111111
111111111111111100000000000000000000000000000000000000000000000000000000000000000000000000000000000000011111111111111111111
111111111111111100000000000000000000000000000000000000000000000000000000000000000000000000000000000000011111111111111111111
111111111111111100000000000000000000000000000000000000000000000000000000000000000000000000000000000000011111111111111111111
111111111111111100000000000000000000000000000000000000000000000000000000000000000000000000000000000000011111111111111111111
111111111111111100000000000000000000000000000000000000000000000000000000000000000000000000000000000000011111111111111111111
111111111111111100000000000000000000000000000000000000000000000000000000000000000000000000000000000000011111111111111111111
111111111111111100000000000000000000000000000000000000000000000000000000000000000000000000000000000000011111111111111111111
111111111111111100000000000000000000000000000000000000000000000000000000000000000000000000000000000000011111111111111111111
111111111111111100000000000000000000000000000000000000000000000000000000000000000000000000000000000000011111111111111111111
111111111111111100000000000000000000000000000000000000000000000000000000000000000000000000000000000000011111111111111111111
111111111111111100000000000000000000000000000000000000000000000000000000000000000000000000000000000000011111111111111111111
111111111111111100000000000000000000000000000000000000000000000000000000000000000000000000000000000000011111111111111111111
111111111111111100000000000000000000000000000000000000000000000000000000000000000000000000000000000000011111111111111111111
111111111111111100000000000000000000000000000000000000000000000000000000000000000000000000000000000000011111111111111111111
111111111111111100000000000000000000000000000000000000000000000000000000000000000000000000000000000000011111111111111111111
111111111111111100000000000000000000000000000000000000000000000000000000000000000000000000000000000000011111111111111111111
111111111111111100000000000000000000000000000000000000000000000000000000000000000000000000000000000000011111111111111111111
111111111111111100000000000000000000000000000000000000000000000000000000000000000000000000000000000000011111111111111111111
111111111111111100000000000000000000000000000000000000000000000000000000000000000000000000000000000000011111111111111111111
111111111111111100000000000000000000000000000000000000000000000000000000000000000000000000000000000000011111111111111111111
111111111111111100000000000000000000000000000000000000000000000000000000000000000000000000000000000000011111111111111111111
111111111111111100000000000000000000000000000000000000000000000000000000000000000000000000000000000000011111111111111111111
111111111111111100000000000000000000000000000000000000000000000000000000000000000000000000000000000000011111111111111111111
111111111111111100000000000000000000000000000000000000000000000000000000000000000000000000000000000000011111111111111111111
111111111111111100000000000000000000000000000000000000000000000000000000000000000000000000000000000000011111111111111111111
111111111111111100000000000000000000000000000000000000000000000000000000000000000000000000000000000000011111111111111111111
111111111111111100000000000000000000000000000000000000000000000000000000000000000000000000000000000000011111111111111111111
111111111111111100000000000000000000000000000000000000000000000000000000000000000000000000000000000000011111111111111111111
111111111111111100000000000000000000000000000000000000000000000000000000000000000000000000000000000000011111111111111111111
111111111111111100000000000000000000000000000000000000000000000000000000000000000000000000000000000000011111111111111111111
111111111111111100000000000000000000000000000000000000000000000000000000000000000000000000000000000000011111111111111111111
111111111111111100000000000000000000000000000000000000000000000000000000000000000000000000000000000000011111111111111111111
111111111111111100000000000000000000000000000000000000000000000000000000000000000000000000000000000000011111111111111111111
111111111111111100000000000000000000000000000000000000000000000000000000000000000000000000000000000000011111111111111111111
111111111111111100000000000000000000000000000000000000000000000000000000000000000000000000000000000000011111111111111111111
111111111111111100000000000000000000000000000000000000000000000000000000000000000000000000000000000000011111111111111111111
111111111111111100000000000000000000000000000000000000000000000000000000000000000000000000000000000000011111111111111111111
111111111111111100000000000000000000000000000000000000000000000000000000000000000000000000000000000000011111111111111111111
111111111111111100000000000000000000000000000000000000000000000000000000000000000000000000000000000000011111111111111111111
111111111111111100000000000000000000000000000000000000000000000000000000000000000000000000000000000000011111111111111111111
111111111111111100000000000000000000000000000000000000000000000000000000000000000000000000000000000000011111111111111111111
111111111111111100000000000000000000000000000000000000000000000000000000000000000000000000000000000000011111111111111111111
111111111111111100000000000000000000000000000000000000000000000000000000000000000000000000000000000000011111111111111111111
111111111111111100000000000000000000000000000000000000000000000000000000000000000000000000000000000000011111111111111111111
111111111111111100000000000000000000000000000000000000000000000000000000000000000000000000000000000000011111111111111111111
111111111111111100000000000000000000000000000000000000000000000000000000000000000000000000000000000000011111111111111111111
111111111111111100000000000000000000000000000000000000000000000000000000000000000000000000000000000000011111111111111111111
111111111111111100000000000000000000000000000000000000000000000000000000000000000000000000000000000000011111111111111111111
111111111111111100000000000000000000000000000000000000000000000000000000000000000000000000000000000000011111111111111111111
111111111111111100000000000000000000000000000000000000000000000000000000000000000000000000000000000000011111111111111111111
111111111111111100000000000000000000000000000000000000000000000000000000000000000000000000000000000000011111111111111111111
111111111111111100000000000000000000000000000000000000000000000000000000000000000000000000000000000000011111111111111111111
111111111111111100000000000000000000000000000000000000000000000000000000000000000000000000000000000000011111111111111111111
111111111111111100000000000000000000000000000000000000000000000000000000000000000000000000000000000000011111111111111111111
111111111111111100000000000000000000000000000000000000000000000000000000000000000000000000000000000000011111111111111111111
111111111111111100000000000000000000000000000000000000000000000000000000000000000000000000000000000000011111111111111111111
111111111111111100000000000000000000000000000000000000000000000000000000000000000000000000000000000000011111111111111111111
111111111111111100000000000000000000000000000000000000000000000000000000000000000000000000000000000000011111111111111111111
111111111111111100000000000000000000000000000000000000000000000000000000000000000000000000000000000000011111111111111111111
111111111111111100000000000000000000000000000000000000000000000000000000000000000000000000000000000000011111111111111111111
111111111111111100000000000000000000000000000000000000000000000000000000000000000000000000000000000000011111111111111111111
111111111111111100000000000000000000000000000000000000000000000000000000000000000000000000000000000000011111111111111111111
111111111111111100000000000000000000000000000000000000000000000000000000000000000000000000000000000000011111111111111111111
111111111111111100000000000000000000000000000000000000000000000000000000000000000000000000000000000000011111111111111111111
111111111111111100000000000000000000000000000000000000000000000000000000000000000000000000000000000000011111111111111111111
111111111111111100000000000000000000000000000000000000000000000000000000000000000000000000000000000000011111111111111111111
111111111111111100000000000000000000000000000000000000000000000000000000000000000000000000000000000000011111111111111111111
111111111111111100000000000000000000000000000000000000000000000000000000000000000000000000000000000000011111111111111111111
111111111111111100000000000000000000000000000000000000000000000000000000000000000000000000000000000000011111111111111111111
111111111111111100000000000000000000000000000000000000000000000000000000000000000000000000000000000000011111111111111111111
111111111111111100000000000000000000000000000000000000000000000000000000000000000000000000000000000000011111111111111111111
111111111111111100000000000000000000000000000000000000000000000000000000000000000000000000000000000000011111111111111111111
111111111111111100000000000000000000000000000000000000000000000000000000000000000000000000000000000000011111111111111111111
111111111111111100000000000000000000000000000000000000000000000000000000000000000000000000000000000000011111111111111111111
111111111111111100000000000000000000000000000000000000000000000000000000000000000000000000000000000000011111111111111111111
111111111111111100000000000000000000000000000000000000000000000000000000000000000000000000000000000000011111111111111111111
111111111111111100000000000000000000000000000000000000000000000000000000000000000000000000000000000000011111111111111111111
111111111111111100000000000000000000000000000000000000000000000000000000000000000000000000000000000000011111111111111111111
111111111111111100000000000000000000000000000000000000000000000000000000000000000000000000000000000000011111111111111111111
111111111111111100000000000000000000000000000000000000000000000000000000000000000000000000000000000000011111111111111111111
111111111111111100000000000000000000000000000000000000000000000000000000000000000000000000000000000000011111111111111111111
111111111111111100000000000000000000000000000000000000000000000000000000000000000000000000000000000000011111111111111111111
111111111111111100000000000000000000000000000000000000000000000000000000000000000000000000000000000000011111111111111111111
111111111111111111111111111111111111111111111111111111111111111111111111111111111111111111111111111111111111111111111111111
111111111111111111111111111111111111111111111111111111111111111111111111111111111111111111111111111111111111111111111111111
111111111111111111111111111111111111111111111111111111111111111111111111111111111111111111111111111111111111111111111111111
111111111111111111111111111111111111111111111111111111111111111111111111111111111111111111111111111111111111111111111111111
111111111111111111111111111111111111111111111111111111111111111111111111111111111111111111111111111111111111111111111111111
111111111111111111111111111111111111111111111111111111111111111111111111111111111111111111111111111111111111111111111111111

