NO srcs/textures/north.xpm
SO srcs/textures/south.xpm
WE srcs/textures/west.xpm
EA srcs/textures/east.xpm
F 150,30,10
C 150,30,10



111111111111111111111111111111111111111111111111111111111111111111111111111111111111111111111111111111111111111111111111111
111111111111111111111111111111111111111111111111111111111111111111111111111111111111111111111111111111111111111111111111111
111111111111111111111111111111111111111111111111111111111111111111111111111111111111111111111111111111111111111111111111111
111111111111111111111111111111111111111111111111111111111111111111111111111111111111111111111111111111111111111111111111111
111111111111111000000000011111111111111111111111111111111111111111111111111111111111111111111111111111111111111111111111111
111111111111111000000000011111111111111111111111111111111111111111111111111111111111111111111111111111111111111111111111111
111111111111111000000000011111111111111111111111111111111111111111111111111111111111111111111111111111111111111111111111111
111111111111111000000000011111111111111111111111111111111111111111111111111111111111111111111111111111111111111111111111111
111111111111111000000000011111111111111111111111111111111111111111111111111111111111111111111111111111111111111111111111111
111111111111111111111111111111111111111111111111111111111111111111111111111111111111111111111111111111111111111111111111111
111111111111111111111111111111111111111111111111111111111111111111111111111111111111111111111111111111111111111111111111111
111111111111111111111111111111111111111111111111111111111111111111111111111111111111111111111111111111111111111111111111111
111111111111111111111111111111111111111111111111111111111111111111111111111111111111111111111111111111111111111111111111111
111111111111111111111111111111111111111111111111111111111111111111111111111111111111111111111111111111111111111111111111111
111111111111111111111111111111111111111111111111111111111111111111111111111111111111111111111111111111111111111111111111111
111111111111111111111111111111111111111111111111111111111111111111111111111111111111111111111111111111111111111111111111111
111111111111111111111111111111111111111111111111111111111111111111111111111111111111111111111111111111111111111111111111111
111111111111111111111111111111111111111111111111111111111111111111111111111111111111111111111111111111111111111111111111111
111111111111111111111111111111111111111111111111111111111111111111111111111111111111111111111111111111111111111111111111111
111111111111111111111111111111111111111111111111111111111111111111111111111111111111111111111111111111111111111111111111111
111111111111111111111111111111111111111111111111111111111111111111111111111111111111111111111111111111111111111111111111111
111111111111111111111111111111111111111111111111111111111111111111111111111111111111111111111111111111111111111111111111111
111111111111111111111111111111111111111111111111111111111111111111111111111111111111111111111111111111111111111111111111111
111111111111111111111111111111111111111111111111111111111111111111111111111111111111111111111111111111111111111111111111111
111111111111111111111111111111111111111111111111111111111111111111111111111111111111111111111111111111111111111111111111111
111111111111111111111111111111111111111111111111111111111111111111111111111111111111111111111111111111111111111111111111111
111111111111111111111111111111111111111111111111111111111111111111111111111111111111111111111111111111111111111111111111111
111111111111111111111111111111111111111111111111111111111111111111111111111111111111111111111111111111111111111111111111111
111111111111111111111111111111111111111111111111111111111111111111111111111111111111111111111111111111111111111111111111111
111111111111111111111111111111111111111111111111111111111111111111111111111111111111111111111111111111111111111111111111111
111111111111111100000000000000000000000000000000000000000000000000000000000000000000000000000000000000011111111111111111111
111111111111111100000000000000000000000000000000000000000000000000000000000000000000000000000000000000011111111111111111111
111111111111111100000000000000000000000000000000000000000000000000000000000000000000000000000000000000011111111111111111111
111111111111111100000000000000000000000000000000000000000000000000000000000000000000000000000000000000011111111111111111111
111111111111111100000000000000000000000000000000000000000000000000000000000000000000000000000000000000011111111111111111111
111111111111111100000000000000000000000000000000000000000000000000000000000000000000000000000000000000011111111111111111111
111111111111111100000000000000000000000000000000000000000000000000000000000000000000000000000000000000011111111111111111111
111111111111111100000000000000000000000000000000000000000000000000000000000000000000000000000000000000011111111111111111111
111111111111111100000000000000000000000000000000000000000000000000000000000000000000000000000000000000011111111111111111111
111111111111111100000000000000000000000000000000000000000000000000000000000000000000000000000000000000011111111111111111111
111111111111111100000000000000000000000000000000000000000000000000000000000000000000000000000000000000011111111111111111111
111111111111111100000000000001010010101000000000000000000000000000000000000000000000000000000000000000011111111111111111111
111111111111111100000000000000000000000100000001000000000000000000000000000000000000000000000000000000011111111111111111111
111111111111111100000000000000000000000011010010010000000000100000000000000000000000000000000000000000011111111111111111111
111111111111111100000000000000000000000000011000001100000001001000000000000000000000000000000000000000011111111111111111111
111111111111111100000000000000000000000000000000000000000100000100000000000000000000000000000000000000011111111111111111111
111111111111111100000000000000000000000000000000000010010000000010000000000000000000000000000000000000011111111111111111111
111111111111111100000000000000000000000000000000000011100000000001000000000000000000000000000000000000011111111111111111111
111111111111111100000000000000000000000000000000000001000000000000100001000000000000000000000000000000011111111111111111111
111111111111111100000000000000000000000000000000000000000000000010010010000000000000000000000000000000011111111111111111111
111111111111111100000000000000000000000000000000000000000000000000001000110000000000000000000000000000011111111111111111111
111111111111111100000000000000000000000000000000000000000000000000000000010000000000000000000000000000011111111111111111111
111111111111111100000000000000000000000000000001111000000000000000000000001100010100000000000000000000011111111111111111111
111111111111111100000000000000000000010000000000001100000000000000000000000100100001000000000000000000011111111111111111111
111111111111111100000000000000000000000000000000000000000000000000000000000001000001111000000000000000011111111111111111111
111111111111111100000000000000010000000000000000000000000000000000000000001001000000011000000000000000011111111111111111111
111111111111111100000000000000001000000000000000000000000000000000000000000000000000100000000000000000011111111111111111111
111111111111111100000000000000000100000000000000000000000000000000000000000000000000000010000000000000011111111111111111111
111111111111111100000000000000000010000000000000000000000000000000000000000000000001000101000000000000011111111111111111111
111111111111111100000000000000000001000000000000000000000000000000000000000000000010000000110101010101111111111111111111111
111111111111111100000000000000000000100000000000000000000000000000000000000000000000001000000000000000011111111111111111111
111111111111111100000000000000000000000000000000001000000000000000010000000000000100010010000000000000011111111111111111111
111111111111111100000000000000000000010000000000000000000000000110000000000000001110100001000000000000011111111111111111111
111111111111111100000000000000000000001000000000010000000000111111111111111100010011100000100000000000011111111111111111111
111111111111111100000000000000000000000100000000100000000000010000001110000000100010000000000000000000011111111111111111111
11111111111111110000000000000000000000001000000000000000000000000000S00000000100011000001001000000000011111111111111111111
111111111111111100000000000000000000000000000001001000000000100100000011000000001001100000001000000000011111111111111111111
111111111111111100000000000000000000000001000010000000000001000000000001000010010001000000100100000000011111111111111111111
111111111111111100000000000000000000000000100100000000000110000000001000100110111001000000000010000000011111111111111111111
111111111111111100000000000000000000100000011000000001001000000000000000101000000000000000000001000000011111111111111111111
11111111111111110000000000000000001000000000000000000011000000000000000001000000001000000000010010000000011111111111111111111
111111111111111100000000000000000000000000010000000000000000000000000000000000000000000000010000000000011111111111111111111
111111111111111100000000000000000000000000000000000100100000000000010000000000000000000000000000000000011111111111111111111
111111111111111100000000000000000010000000000000000000110000000000000000000000000000100000000000000000011111111111111111111
111111111111111100000000000000000010000000000000000000000001000000000000000000000000000000000000000000011111111111111111111
111111111111111100000000000000000000000000000000000000000000000000000000010000000000000000100000000000011111111111111111111
11111111111111110000000000000000000010000000000010000000001000000000000000000000000000000000000000000000011111111111111111111
111111111111111100000000000000000000000000100000000000000000000000000000000000000000000000000000000000011111111111111111111
1111111111111111000000000000000000000000001000000000000000000100000000000000000000000001000000000000011111111111111111111
111111111111111100000000000000000000000000000000000001000000000000001000000010000000000000000000000000011111111111111111111
111111111111111100000000000000000000000000000000000000000000000000000000000000000000000000000000000000011111111111111111111
111111111111111100000000000000000000000000000000000000000000000000000000000000000000000000000000000000011111111111111111111
111111111111111100000000000000000000000000000000000000000000000000000000000000000000000000000000000000011111111111111111111
111111111111111100000000000000000000000000000000000000000000000000000000000000000000000000000000000000011111111111111111111
111111111111111100000000000000000000000000000000000000000000000000000000000000000000000000000000000000011111111111111111111
111111111111111100000000000000000000000000000000000000000000000000000000000000000000000000000000000000011111111111111111111
111111111111111100000000000000000000000000000000000000000000000000000000000000000000000000000000000000011111111111111111111
111111111111111100000000000000000000000000000000000000000000000000000000000000000000000000000000000000011111111111111111111
111111111111111100000000000000000000000000000000000000000000000000000000000000000000000000000000000000011111111111111111111
111111111111111100000000000000000000000000000000000000000000000000000000000000000000000000000000000000011111111111111111111
111111111111111100000000000000000000000000000000000000000000000000000000000000000000000000000000000000011111111111111111111
111111111111111100000000000000000000000000000000000000000000000000000000000000000000000000000000000000011111111111111111111
111111111111111100000000000000000000000000000000000000000000000000000000000000000000000000000000000000011111111111111111111
111111111111111100000000000000000000000000000000000000000000000000000000000000000000000000000000000000011111111111111111111
111111111111111100000000000000000000000000000000000000000000000000000000000000000000000000000000000000011111111111111111111
111111111111111100000000000000000000000000000000000000000000000000000000000000000000000000000000000000011111111111111111111
111111111111111100000000000000000000000000000000000000000000000000000000000000000000000000000000000000011111111111111111111
111111111111111100000000000000000000000000000000000000000000000000000000000000000000000000000000000000011111111111111111111
111111111111111100000000000000000000000000000000000000000000000000000000000000000000000000000000000000011111111111111111111
111111111111111100000000000000000000000000000000000000000000000000000000000000000000000000000000000000011111111111111111111
111111111111111100000000000000000000000000000000000000000000000000000000000000000000000000000000000000011111111111111111111
111111111111111100000000000000000000000000000000000000000000000000000000000000000000000000000000000000011111111111111111111
111111111111111100000000000000000000000000000000000000000000000000000000000000000000000000000000000000011111111111111111111
111111111111111100000000000000000000000000000000000000000000000000000000000000000000000000000000000000011111111111111111111
111111111111111100000000000000000000000000000000000000000000000000000000000000000000000000000000000000011111111111111111111
111111111111111100000000000000000000000000000000000000000000000000000000000000000000000000000000000000011111111111111111111
111111111111111100000000000000000000000000000000000000000000000000000000000000000000000000000000000000011111111111111111111
111111111111111100000000000000000000000000000000000000000000000000000000000000000000000000000000000000011111111111111111111
111111111111111100000000000000000000000000000000000000000000000000000000000000000000000000000000000000011111111111111111111
111111111111111100000000000000000000000000000000000000000000000000000000000000000000000000000000000000011111111111111111111
111111111111111100000000000000000000000000000000000000000000000000000000000000000000000000000000000000011111111111111111111
111111111111111100000000000000000000000000000000000000000000000000000000000000000000000000000000000000011111111111111111111
111111111111111100000000000000000000000000000000000000000000000000000000000000000000000000000000000000011111111111111111111
111111111111111100000000000000000000000000000000000000000000000000000000000000000000000000000000000000011111111111111111111
111111111111111100000000000000000000000000000000000000000000000000000000000000000000000000000000000000011111111111111111111
111111111111111100000000000000000000000000000000000000000000000000000000000000000000000000000000000000011111111111111111111
111111111111111100000000000000000000000000000000000000000000000000000000000000000000000000000000000000011111111111111111111
111111111111111100000000000000000000000000000000000000000000000000000000000000000000000000000000000000011111111111111111111
111111111111111100000000000000000000000000000000000000000000000000000000000000000000000000000000000000011111111111111111111
111111111111111100000000000000000000000000000000000000000000000000000000000000000000000000000000000000011111111111111111111
111111111111111100000000000000000000000000000000000000000000000000000000000000000000000000000000000000011111111111111111111
111111111111111100000000000000000000000000000000000000000000000000000000000000000000000000000000000000011111111111111111111
111111111111111100000000000000000000000000000000000000000000000000000000000000000000000000000000000000011111111111111111111
111111111111111100000000000000000000000000000000000000000000000000000000000000000000000000000000000000011111111111111111111
111111111111111100000000000000000000000000000000000000000000000000000000000000000000000000000000000000011111111111111111111
111111111111111100000000000000000000000000000000000000000000000000000000000000000000000000000000000000011111111111111111111
111111111111111100000000000000000000000000000000000000000000000000000000000000000000000000000000000000011111111111111111111
111111111111111100000000000000000000000000000000000000000000000000000000000000000000000000000000000000011111111111111111111
111111111111111100000000000000000000000000000000000000000000000000000000000000000000000000000000000000011111111111111111111
111111111111111100000000000000000000000000000000000000000000000000000000000000000000000000000000000000011111111111111111111
111111111111111100000000000000000000000000000000000000000000000000000000000000000000000000000000000000011111111111111111111
111111111111111100000000000000000000000000000000000000000000000000000000000000000000000000000000000000011111111111111111111
111111111111111100000000000000000000000000000000000000000000000000000000000000000000000000000000000000011111111111111111111
111111111111111100000000000000000000000000000000000000000000000000000000000000000000000000000000000000011111111111111111111
111111111111111100000000000000000000000000000000000000000000000000000000000000000000000000000000000000011111111111111111111
111111111111111100000000000000000000000000000000000000000000000000000000000000000000000000000000000000011111111111111111111
111111111111111100000000000000000000000000000000000000000000000000000000000000000000000000000000000000011111111111111111111
111111111111111100000000000000000000000000000000000000000000000000000000000000000000000000000000000000011111111111111111111
111111111111111100000000000000000000000000000000000000000000000000000000000000000000000000000000000000011111111111111111111
111111111111111100000000000000000000000000000000000000000000000000000000000000000000000000000000000000011111111111111111111
111111111111111100000000000000000000000000000000000000000000000000000000000000000000000000000000000000011111111111111111111
111111111111111100000000000000000000000000000000000000000000000000000000000000000000000000000000000000011111111111111111111
111111111111111100000000000000000000000000000000000000000000000000000000000000000000000000000000000000011111111111111111111
111111111111111100000000000000000000000000000000000000000000000000000000000000000000000000000000000000011111111111111111111
111111111111111100000000000000000000000000000000000000000000000000000000000000000000000000000000000000011111111111111111111
111111111111111100000000000000000000000000000000000000000000000000000000000000000000000000000000000000011111111111111111111
111111111111111100000000000000000000000000000000000000000000000000000000000000000000000000000000000000011111111111111111111
111111111111111100000000000000000000000000000000000000000000000000000000000000000000000000000000000000011111111111111111111
111111111111111100000000000000000000000000000000000000000000000000000000000000000000000000000000000000011111111111111111111
111111111111111100000000000000000000000000000000000000000000000000000000000000000000000000000000000000011111111111111111111
111111111111111100000000000000000000000000000000000000000000000000000000000000000000000000000000000000011111111111111111111
111111111111111100000000000000000000000000000000000000000000000000000000000000000000000000000000000000011111111111111111111
111111111111111100000000000000000000000000000000000000000000000000000000000000000000000000000000000000011111111111111111111
111111111111111100000000000000000000000000000000000000000000000000000000000000000000000000000000000000011111111111111111111
111111111111111100000000000000000000000000000000000000000000000000000000000000000000000000000000000000011111111111111111111
111111111111111100000000000000000000000000000000000000000000000000000000000000000000000000000000000000011111111111111111111
111111111111111100000000000000000000000000000000000000000000000000000000000000000000000000000000000000011111111111111111111
111111111111111100000000000000000000000000000000000000000000000000000000000000000000000000000000000000011111111111111111111
111111111111111100000000000000000000000000000000000000000000000000000000000000000000000000000000000000011111111111111111111
111111111111111100000000000000000000000000000000000000000000000000000000000000000000000000000000000000011111111111111111111
111111111111111100000000000000000000000000000000000000000000000000000000000000000000000000000000000000011111111111111111111
111111111111111100000000000000000000000000000000000000000000000000000000000000000000000000000000000000011111111111111111111
111111111111111100000000000000000000000000000000000000000000000000000000000000000000000000000000000000011111111111111111111
111111111111111100000000000000000000000000000000000000000000000000000000000000000000000000000000000000011111111111111111111
111111111111111100000000000000000000000000000000000000000000000000000000000000000000000000000000000000011111111111111111111
111111111111111100000000000000000000000000000000000000000000000000000000000000000000000000000000000000011111111111111111111
111111111111111100000000000000000000000000000000000000000000000000000000000000000000000000000000000000011111111111111111111
111111111111111100000000000000000000000000000000000000000000000000000000000000000000000000000000000000011111111111111111111
111111111111111100000000000000000000000000000000000000000000000000000000000000000000000000000000000000011111111111111111111
111111111111111100000000000000000000000000000000000000000000000000000000000000000000000000000000000000011111111111111111111
111111111111111100000000000000000000000000000000000000000000000000000000000000000000000000000000000000011111111111111111111
111111111111111100000000000000000000000000000000000000000000000000000000000000000000000000000000000000011111111111111111111
111111111111111100000000000000000000000000000000000000000000000000000000000000000000000000000000000000011111111111111111111
111111111111111100000000000000000000000000000000000000000000000000000000000000000000000000000000000000011111111111111111111
111111111111111100000000000000000000000000000000000000000000000000000000000000000000000000000000000000011111111111111111111
111111111111111100000000000000000000000000000000000000000000000000000000000000000000000000000000000000011111111111111111111
111111111111111100000000000000000000000000000000000000000000000000000000000000000000000000000000000000011111111111111111111
111111111111111100000000000000000000000000000000000000000000000000000000000000000000000000000000000000011111111111111111111
111111111111111100000000000000000000000000000000000000000000000000000000000000000000000000000000000000011111111111111111111
111111111111111100000000000000000000000000000000000000000000000000000000000000000000000000000000000000011111111111111111111
111111111111111100000000000000000000000000000000000000000000000000000000000000000000000000000000000000011111111111111111111
111111111111111100000000000000000000000000000000000000000000000000000000000000000000000000000000000000011111111111111111111
111111111111111100000000000000000000000000000000000000000000000000000000000000000000000000000000000000011111111111111111111
111111111111111100000000000000000000000000000000000000000000000000000000000000000000000000000000000000011111111111111111111
111111111111111100000000000000000000000000000000000000000000000000000000000000000000000000000000000000011111111111111111111
111111111111111100000000000000000000000000000000000000000000000000000000000000000000000000000000000000011111111111111111111
111111111111111100000000000000000000000000000000000000000000000000000000000000000000000000000000000000011111111111111111111
111111111111111100000000000000000000000000000000000000000000000000000000000000000000000000000000000000011111111111111111111
111111111111111100000000000000000000000000000000000000000000000000000000000000000000000000000000000000011111111111111111111
111111111111111100000000000000000000000000000000000000000000000000000000000000000000000000000000000000011111111111111111111
111111111111111100000000000000000000000000000000000000000000000000000000000000000000000000000000000000011111111111111111111
111111111111111100000000000000000000000000000000000000000000000000000000000000000000000000000000000000011111111111111111111
111111111111111100000000000000000000000000000000000000000000000000000000000000000000000000000000000000011111111111111111111
111111111111111100000000000000000000000000000000000000000000000000000000000000000000000000000000000000011111111111111111111
111111111111111100000000000000000000000000000000000000000000000000000000000000000000000000000000000000011111111111111111111
111111111111111100000000000000000000000000000000000000000000000000000000000000000000000000000000000000011111111111111111111
111111111111111100000000000000000000000000000000000000000000000000000000000000000000000000000000000000011111111111111111111
111111111111111100000000000000000000000000000000000000000000000000000000000000000000000000000000000000011111111111111111111
111111111111111100000000000000000000000000000000000000000000000000000000000000000000000000000000000000011111111111111111111
111111111111111100000000000000000000000000000000000000000000000000000000000000000000000000000000000000011111111111111111111
111111111111111100000000000000000000000000000000000000000000000000000000000000000000000000000000000000011111111111111111111
111111111111111100000000000000000000000000000000000000000000000000000000000000000000000000000000000000011111111111111111111
111111111111111100000000000000000000000000000000000000000000000000000000000000000000000000000000000000011111111111111111111
111111111111111100000000000000000000000000000000000000000000000000000000000000000000000000000000000000011111111111111111111
111111111111111100000000000000000000000000000000000000000000000000000000000000000000000000000000000000011111111111111111111
111111111111111100000000000000000000000000000000000000000000000000000000000000000000000000000000000000011111111111111111111
111111111111111111111111111111111111111111111111111111111111111111111111111111111111111111111111111111111111111111111111111
111111111111111111111111111111111111111111111111111111111111111111111111111111111111111111111111111111111111111111111111111
111111111111111111111111111111111111111111111111111111111111111111111111111111111111111111111111111111111111111111111111111
111111111111111111111111111111111111111111111111111111111111111111111111111111111111111111111111111111111111111111111111111
111111111111111111111111111111111111111111111111111111111111111111111111111111111111111111111111111111111111111111111111111
111111111111111111111111111111111111111111111111111111111111111111111111111111111111111111111111111111111111111111111111111

