WE      demo/textures/west.xpm




F       150,30,10

    EA       demo/textures/south.xpm

    SO       demo/textures/east.xpm

C 150,30,10
NO        demo/textures/north.xpm       


       1111111111
1111111001
1000000001
1000000001
1000000001
1000000001
1000000001
1000000001
1000000001
1000000001
1000000001
1000000001
1000000001
1000000001
1000000001
1000000001
1000000001
1000000001
1000000001
1000000001
1000000001
1000000001
1000000001
1000000001
1000000001
1000000001
1000000001
1000000001
1000000001
1000000001
1000000001
1000000001
1000000001
1000000001
1000000001
1000000001
1000000001
1000000001
111111110111111111111111111111111111111111111111111111111111111111111
1000000000000000000000000000000000000010000000000000000000000000000001
101111111111111111111111111111111100000W00000000000001111111111111101
100000000000000000000000000000000100000000000000000001000000000000001
111111111111111111111111111111111111111111111111111111111111111111111


