NO srcs/textures/north.xpm
SO srcs/textures/south.xpm
WE srcs/textures/west.xpm
EA srcs/textures/east.xpm
F 20,20,20
C 150,30,10

        111111111111111 111111111
        1000000000110001000000001
        1011000001110000000000001
        1001000000000000000000001
111111111011000001110000000000001
100000000011000001110111111111111
11110111111111011100000010001
11110111111111011101010010001
110000001101010111000000100011111111111111111111111111111111111111
1E0000000000000000000000000000000000000000000000000000000000000001
100000000000000011010100100011111111111111111111111111111111111111
1100000111010101111101111000111
11110111 1110101 101111010001
11111111 1111111 111111111111
